1111111111
101P10C001
1000000001
1000000001
110E000E01
1000000111
1111111111
