1111111111
1000000001
1000000001
1E00000001
100001C101
1111111111
