1111111111111
1001000E00001
1000011111001
1P001110000C1
1111111111111
