1111111111
1000000001
1000000001
1E0000P001
1000011101
1111111111
