11111111111111
10000000000001
100010000C0011
10P0E000010011
11111111111111
11111111111111