11111111111111111111111111111111111111111111
10000000000000000011111100000000000000011111
10P01011111111100011111100000000000000000111
10001011111111100011111100000001111100000001
10001000000000000011111100000001111100000001
10001111111110000000001100000001111100000001
100000CCC00CCC01CCC0001100000001111100001111
10000000000000000000001100000000000000000001
10111000000000000000001100000001111100000001
10C11000000000000000001100000000CCC100000011
10111000000000000000011000000001CCC100000001
10000110000011000000000000000001111100000001
10000110000000000000000000000000000000000001
10000110CC0111110000000000000000000000000001
10000110CC0111110000000000000000000000011001
1000000111100000000000CCCC000000001111000001
1000000000000000000000CCCC000000000000000111
1011000000000110000000CCCC000000000000000001
10000000110001100000000000000011100000000001
10000000110001100000000000000011100000000001
10000000100001100111000000111011100000000001
100000001000011001C0000000111011100000000001
100000001000011000C000CC00111011100000000001
1000000010000110011100CC00111011100000000001
100110001000011001C000CC00000011100000000001
10000000100000000111111111111111100000000001
10000000100000000000000000000000000110000001
111000000001111111000000000000000E0000000001
10000000000000000000000000011111000001110001
11110000000000000000000000000000011000000111
11111111111111111111111111111111111111111111