11111111111111
10000000000001
100000100C0011
10P000100E0011
11111111111111
11111111111111